Niveau 1
resources/tileSetMinecraft32x32.png
30 20 32 32
0 26 26 26 0 0 0 0 0 0 0 0 0 0 0 0 0 0 0 0 130 0 0 0 0 0 0 0 0 0 
26 26 26 26 26 0 0 0 0 0 0 0 0 0 0 0 0 7 7 7 7 0 0 0 0 0 0 0 0 0 
26 26 26 26 26 0 0 0 0 0 0 0 0 0 0 0 7 7 29 29 7 7 0 0 0 27 27 27 0 0 
0 0 20 0 0 61 61 0 0 0 0 0 0 0 0 7 7 29 29 29 29 7 7 0 0 27 27 27 27 0 
57 57 20 57 2 2 2 61 59 0 0 0 0 0 0 7 89 89 8 8 89 89 7 0 0 0 27 27 27 0 
2 2 2 2 3 3 3 2 2 0 117 117 0 0 0 7 8 8 8 123 8 8 7 0 0 0 0 22 0 0 
3 3 3 3 3 3 1 1 3 2 2 2 57 57 57 7 98 99 8 139 121 108 7 0 0 0 0 22 0 0 
3 3 3 3 3 1 1 1 1 3 3 3 2 2 2 4 4 4 54 4 4 4 4 57 147 57 57 22 60 60 
3 1 1 3 3 1 18 18 1 1 3 3 3 1 1 3 3 3 66 66 3 3 3 2 2 2 2 2 2 2 
3 1 1 1 1 1 18 18 18 1 3 3 3 1 1 1 3 3 3 66 66 3 3 3 3 1 3 3 3 3 
3 1 17 1 1 1 18 18 1 1 1 1 1 1 1 1 1 1 1 3 66 66 3 3 1 1 3 18 18 1 
1 1 17 1 1 1 18 18 1 1 159 159 159 159 159 1 1 1 1 17 1 66 66 3 1 1 18 18 18 1 
1 1 17 1 1 1 18 1 1 159 159 159 159 159 159 159 159 159 159 17 17 1 66 66 1 1 18 18 18 1 
1 17 17 1 1 1 1 1 1 159 159 66 66 66 66 66 66 66 66 159 159 159 1 66 66 18 18 18 18 18 
1 1 1 1 1 1 1 1 159 159 66 66 66 66 66 66 66 66 66 66 66 159 159 1 66 66 18 18 18 18 
1 1 1 1 1 1 1 159 66 66 66 66 66 79 79 79 79 79 79 66 66 66 66 66 66 66 66 66 18 1 
1 1 1 1 1 1 1 159 66 66 66 66 79 79 79 79 79 79 79 79 66 66 66 66 66 66 66 88 1 1 
1 1 1 1 1 1 1 1 159 66 66 79 79 79 79 79 79 79 79 79 66 66 66 1 1 1 1 1 1 1 
1 1 1 1 1 1 1 1 1 105 66 79 79 79 79 79 79 79 79 79 66 66 1 1 1 1 1 1 1 1 
16 16 1 1 1 1 1 1 1 105 105 66 79 79 79 79 79 79 79 66 66 1 1 1 1 1 1 1 1 1 
